tests/tmp/6_check_maze_unicode_solving.txt
█████████████████████
█▲••••••••  █   █   █
█ ███████•█████ █ █ █
█     █•••█     █ █ █
█████ █•███ █████ █ █
█ █   █•••█ █     █ █
█ █ █████•█ █████ █ █
█ █     █•█       █ █
█ █████ █•█████████ █
█       █▼    █   █ █
█ █████████ █ █ ███ █
█     █     █   █   █
█ █████ ███████ █ ███
█ █   █ █ █   █ █ █ █
███ █ █ █ █ █ █ █ █ █
█   █ █ █   █   █ █ █
█ ███ █ █████ ███ █ █
█   █   █   █   █ █ █
█ █ █████ █ █████ █ █
█ █       █         █
█████████████████████
===EOF===
